##############################################################################################################################################################################################
#........########......#.....###############...........#.....###############################......#########################......#####################################################.....###
#...........#####......#.....#####.....#####.#####.....#...........#########################......#########............................##########################################..........###
#........##............#.....###.......###.............#...........#########################......#########.###############............####......................####..........##.####.....###
#........#####.##......#.....###.#.....###.............#...........##......#################......#########.#############..............####......................####..........##.####.....###
#........#####.##......#.....###.#.....###.......#.....#...........##......#################......#########.#######.......#............####......................####..........##.####.....###
#........#####.#########.........#.....###..........####...........##......#################......#########.#######.......#............####......................####..........##.######.#####
###########....#########.....###...#######.......#######...........##......####.........####......#########.#######.......#......##########......................####..........##.######...###
#.............##########.....#####.########.....########...........##......####.........####......#########.#.....#..............###############........#############..........##.########.###
#.....#######.############.............####.....##########.##########......#............####..............#.#.....#......#.......######################.#############.................####.###
#.....#.......#########................####.....##########.......####......#.##.........####......#######.#.#.....#......#.#######################..........######.....#..............#.....##
#.....................#.##.............####.....################.####........##.........#####.###########.........########.#######################..........######.....#..............#.....##
#............####.......##.............####.....##############.....##......####.........#####..........####.#...............######################..........######.....#..............#.....##
#............####.....####.............####.....##############.....#.......####.........##############.####.#...............#..........###########..........######.....#....................##
#.....#......####.....####.################..............#####.....#.......####....................###.####.#...............#..........###########..........######..........................##
############.####.....####.################.....########.#####.....#.......####.........##########.###.####.#..........................###########..........######..........................##
############.####.....####.################.....########...........#.############.################.....####.#..............##..........###################.#######......####.#..............##
############.#############.################........................#.############.####################.####.#..............##..........###################.#######.....#####.####.#####.....##
############.#############.################.....####################.......######.####################......#########.#######.....................................................############
############.#############.............................#.........###.......######.####################.##############.####################################.#################........##########
#######......###########..........#########............#.#.......###.......####..........#############.####.....#####.........############################.......#.........########.##########
#######.################..........#########............#.#.......###.......#.............##.........##.####.....#############.#########.....##############.......#.........###...............#
#######.################..........#########............#.#.......###.....................##.........##.####.....#############.#########.....##############.......#.........###...............#
#######.################..........#########............#.#.......###.......###...........##.........##.####.....#############.#########.....########.......................###...............#
#######.####.........###..........#########............#.#.......###.......###...........##.........##.###......#############.#########......###................##.........###...............#
#######.####.........###..........#########............#.#.......###.......###...........##.........##.###.##########.......#.#########..........###.......####.##.###########...............#
#######.##...........###..........#########..............#.......###.......###...........##.........##.###.##########.......#........###.###.#######.......####.##...#########...............#
#######.##.#.........#####.............####............###.......###.......###...........##.........##.###.##########.......#........###.###......##.......####.####.#########...............#
###......#.#.........#####.............###################.................###.###.########.........##.###.##########.......#........###.####.....##.......####.####.#########.......######.##
###......#.#.........##................################..........###.#########.###.########.........##.###.##########.......#........###.####.....##..########..##......######.......######..#
###......#.#.........##.###............###############..........####.....#####.###.################........##########................###.####.....##.....###.....#......######.......#######.#
###......#.############.###............###############.#........####.....#####.###.################........#################.........###.####.....##.....###.....#......#............###.....#
###......#.############.###............###############.#........####.....#####.###..###############........#########.................##...........##.....###.....#........####.......###.....#
###......#.############......###........##...........#.#........####.....#####.#.......############........#########.........##########...........##.....###.....#......######......####.....#
###........############.................##...........#.#........####.....#####.#.......############........#########.........##########...........##.....###.....#......################.....#
#######################.................##...........#.#........####.....#####.#.......#############.......#########.........##########......#######.....###############################.....#
#######################.................##...........#.#........####.....#####.........#############.......#########.........##########......#######.....#####################################
#######################........#........##...........#.#........################.......#############################.........##########......#######.....#####################################
#######################........###########.............#........################.......#############################.........##########......#######.....#####################################
##############################################################################################################################################################################################
