##############################################################################################################################################################################################
##.......###############################......#########################.....###################..............#############.....##################........................##......######......#
##.......###############################......##################..............#################..............###.........#.......################........................##......######......#
##.......###########.....###############......##################............#.#####..........##...................##...........#.##########.....#........................##.......#####......#
##.......###########.....###############......##################............#.#####..........##...................##.....#.....#.##########.....#........................##..................#
##.......###########.....###############......##..........#.................#.#####..........##...................##.....#.....#.##########.....#........................##..................#
##.......###########.....#######.....###......##..........#............#.####.#####..........##...................##.....#.....#.##########.....#........................##.............######
######.#############.....#######.....###......##..........#............#......#####..........#########............##.....#.....#.....####.......#.........................#......#......######
######.#############.....#######.....###......##................#############................#######.....................#.....#.....####.#.....#.........##########.............#......######
######.#############.....######......###......##........................................############.#############.#.########........####.#.....#.........##########.....##......######.######
######.#################.######......####...............###############################.############........##.....#.######..........####.#.....##############..........................######
######.#################.######......####.......######............................#####.############........##.......######..........####.#.....##############.###############################
######.#################.######......####.......######.##########################.#####.############........##.############..............................................#.................###
######.###########.......######.##.######.......#........................................###########........##.....########...............#.....###.########.............#.................###
######.########.......#########.##.######.......#........................................###########........##.....########.....###########.....###.########...............................###
######.########.......#########.##.######.......#........................................#####################.....########################.....###.########...............................###
######.########.......#########....######.......#........................................#####################.....################################.########.............#.................###
######.########.................#########.......#........................................#####################.....################################........................................###
######.########.......#########.#########.......#........................................######..............#########################.....############......###.....################.########
######.########.......#########.#########.......#............................................................#########################............##.........###.....####........####.########
######.###########.########........######.....########.################.....############.######..............##################............#......##.##......###.....####........####.......##
######.######.......#######........######.....########.################.....############.######..............#########......###......#.....#......##.##......#.......####........####.......##
#####..######.......#######........######.....########.#.......########.............####.######..............#########......###.....##.....#.........##......#.#.....###.........####.......##
###.....#####.......#######........######.....########.#.......##........................######..............#########......###.....##.....#......#####......#.#.....###.........####.......##
###.....###.........#######........######.....########.#....................#######.#........##..............#########......###.....##.....#......#####........#.....###.........####.......##
###.....###.#.......#######...........###.....########.#.......#######......#######..........###.#####################......###.....##.....#......#####......###.....###.........####.......##
###.....###.###.##.########........##.#####.#.########.#.......#######......#########........###.#####################......###.....##.....#.................###.....###....................##
###.........###.##.###########.######.#####.#.########.#.......#######......#########........###.####################.......###.....##.....###########.......#######.###.........#####...#####
#####...#######.##.###########.######.#####.#.########.........######################........###.####################.####..###.....####.#.#####.......####......................##.........##
#####.#########.##.###########......#.#####...##########.......######################........###.####################.........#.....####.#.#####.......####.#############........##.........##
###......######.##.######...........#.........##########.......###################....####.....#...........##########.........#.....####.#.#####.......##...........###############.........##
###......######.##...####.....#.....#########..#########.......###################......##.....###########....................#.....#......#####.......##...........###############.........##
###......######....#.####.....#.....#########..#########.......###################.............#######..........######........#.....#......#####.......##...........###############.........##
###......#######..............#.....#####.......########.......###################.......#.....#######..........######........#.....#.....######.......##...........###############.........##
###......#######..............#.....#####.......########.......###################.......#.....#######..........######..............#.....######.......##...........##########################
###......#######..............#.....#####.......########.......###################.......#.....#######..........######..............#.....######.......##...........##########################
################....................#####.......########.......###################.......#.....#######..........##############......############.......##...........##########################
################..............###########.......########.......###################......##############..........##############......############.......##...........##########################
################.........###############################.......###################......#######################################.....#####################...........##########################
##############################################################################################################################################################################################
