##############################################################################################################################################################################################
############.........###############################################################################################################........................................................##
############.........##......#############......######.........#########################........####################################.##############################################.........##
############.........##......#############......######.........#####............########........####################################.##############################################.........##
############.........##......#############........####.........#####............########........####################################.##############################################.........##
##########...........##......#############......#.####...........###............########........####################################.##############################################.........##
##########.#.........##......#############......#..............#.###............########.............................................##############################################.........##
##########.#.........##......###.......###......######.........#.###............########........###############################.##############################################################
##.......#.#..........#................###......######.........#.###########.###########........###############################.##############################################################
##.......#.####.#####.#.#######.................########.....###.###########.........##########################################...............................................################
##.......#.####.#####.#.....###........##.......######......####.####........#######.########################################################################################.################
##.......#.####...###.#.....###........##...................####.####.#######......#.##################################.....#.....#####################################.....................##
##.......#.######.###.#.....######.######.......#...........####.##.......###......#.#####################..................#...................#######################.....................##
##.......#.######.###.......######.######.......#...........####.##.......###......#.############.......##.###......###.....#.............#####...................###.......................##
##.......#.######.#####.....######.######.......#...........####.##................#.############.......##.###........#.....#.............##########..............###.#.....................##
##.......#.######.#####.....######.######.......#...........####..........###......#.############..........###......#.......#.............##########..................#.....................##
##.......#.######.#####............######.......######......#######.......###......#.############.......######......#########.............##########..............#####.....................##
##.......#.######.#####.....#############...................#######.......###......#.############.......######......#########......#####.###########..............############################
##.......#.######.#####.....############################.##########.......###......#.############.......######.....................#####.###########..............############################
##.......#.######.########.#############################.###########################.########################################.....######.#####################################################
##.........#####.....#####.###########################...................##......###.#######..............#######............#####.......#####################################################
##.......#######.....#####.######.....################.........####......##......###.#######..............#######........................#####################################################
##.......#######.....#####.######.....######......####.........####.......#......###.#######..............#######.............#####......#####################################################
##.......#######.....#####.######.....######......###..........####.......#......###.#######.................###.........................########.........................####################
##.......#######.....#####.######.....######...................####.......#......###.#######..............##.###..............#####.....#########.........................####################
#################.########.######.....######......####.........####.......#......###......................##.###..............#####.........#####.........................####################
#################.########.#########.#######......##########.#.####.......#......###########..............##.###.############.#####.....###.#####.........................####################
#################.########.#########.#######......###........#.####.......#......###########..............##.###.############.#####.....###.#####.........................####################
#################.########.#########.#######......###.########.#########..#####.############..............##..................#####.....###.###########################...............########
#################.########.#########..#############.......####.######.....#####.############..............###########.........###########...........#################################.########
###############...###........########.#############............######.###.#####.###################.####..................###############............###########################........######
###############.#####........##..........##########.......#########.......#####.######.....########.####........................#.......#............#####################..............######
#############.....###........##..........##########.......#########.......#####.######.....#####.....###........................#.......#........................#.............#........######
#############.....###....................##########.......#########................###.....##..........#........................#.......#........................#...........###........######
#############.....###.........#..........##########.......#########................###.........#.....#.#........................#.......###.#########........................###........######
#############.....###........##..........##########.......#########................###.....#####.....#..................................###......................#...........#################
#############.....#############..........##########.......#########................###.....#####.....###.......#################........#############............#...........#################
#############.....#############..........##########.......#########......#.........###.....#############.......#################........#############............#############################
#############.....#################################################......#.........###.....#############.......#################........######################################################
##############################################################################################################################################################################################
