##############################################################################################################################################################################################
######.....................########...............................................##.......#.......##############.....#############################..........#######......####################
######.....................########.#############........###################......##.......#.#.....##..........##.....#############################..........#######......####################
######.....................########.#############........###################......##.......#.#.....##.......##........######..............#########..........#######......####################
######.....................########.#############........##################..................#.....##.......###.#.....######..............#########..........#######......###########.......##
######..............................#############........##################.......##.......###.....##.......###.#.....######..............#########..........#######............#####.......##
##################################.##############...........................########.......###.....##.......###.############..............#########..........############.......#####.......##
##########################.........#######################################################.##########.......###.############..............#########..........###########........#####.......##
##########################.###############################################################.####################.############..............#########..........###########........#####.......##
##########################.###############################################################.........########.....############.............##########..........########...........#######.######
##########################.#########################...............................................########.###############......##################..........########.................#.######
##########################.#########################.....#########.......#################.........########.###############......##################.................#.....###########.#......#
##########################.#########################.....................#################.........########.###############......#####.....########################.#.....###########.######.#
##########################.#########################.....#########.............###########.........####..........##########..........#.....########################.#.....###########.##.....#
##########################.#########################.....#########.......#####.....................####.......##.##..............##..#.....########################.#.....###########.##.....#
##########################.#########################.....#################################.........####.......##........##.########..#.....########################.#.....###########.##.....#
##########################.........................................................####################.......#####.....##.................########################.......###########.##.....#
##########################.#######################################################.####################.......#####.....###########.##.....##########################.....###########........#
##########################.#######.........#######################################.###.............####.......#####.....###########.##.....##########################.....##################.#
####.....#######......####.#######.........#######################################.###.............#####.........##################.########################################################.#
####.....#######......####.#######............#.......############################.###.............#############.##################.###############################..........................#
####.....#######......####.#######.........##.#.......############################.###.............####................############.###############################.##########################
####.........###......####.#######.........##.#.......################.............................####................############.###############################.##########################
####.....###..................####.........##.#........................###########.###.............####................############.#####.......###################.##########################
################......#######.####.........##.#.......############################.....................................############.#####.......###################.##########################
####################.########.####.........##.........################################.............####................############.###.........###################.##########################
####################.########..............###########################################.............#########.######################.###.#.......###################.##########################
####################.#############.........###########################################.............#########.######################.###.#.......###################.##########################
####################.###################################################################################.....######################.###.#.......#################..............###############
###.........########.............................................#######......##########################.####################........##.######.##################..............###############
###................#####.....................################.................##########################.####################........##.######.#######.........................###############
###..........#.....#####.....##############.....######.........................#########################.####################........##.######.#######.##########..............###############
###..........#.....#####........................######..............................################.........################........##.##.....#######.##########..............###############
###..........#.....#####..........#########.....######......................................########.........################........#.........#######.##########..............###############
###..........#.....#####..........#########.................................................########.........################........#.........#######.##########..............###############
###..........#.....##.............#########.....######........################..............########.........################........#.................##########..............###############
###...................#######.....#########.....######.......................#..............########.........################..................##################..............###############
###.........#################.....#########.....############################.#######........#################################........#.........##################..............###############
###.........###############################.....############################................#################################........#.........###############################################
##############################################################################################################################################################################################
