##############################################################################################################################################################################################
##.....#################.........####################...................######################........#############...........##################............#.......##########################
##.....############..............##......############..........########.######.............###.....##.##......#####............#################............#.......##########################
##.....############..............##......############.................#.######.............###.....##.##......#................#......##.....###............#.................########.....###
##.......##########......................##.....#####...........#####......................###.....##.##......#.###............#......##.....###............#.......#########.#.....##.....###
##.....#.##########..............##......##.....#####...........#######............................##.##......#.###............#.............###............#.......#########.#.....##.....###
##.....#.##########......##########.......#.....#####...........##############.............###.....##.##........###....................#.......#......###.#.#.......#########.......##.....###
##.....#.###..........#..##########.......#.....#####...............##########.............###.....##.##......#####...........##.......#.....#.#......###.#.........###########.....##.....###
##.....#.###.......#.##..################.......#####..........####.#################################.........##############.###.......#.....#.#......###.##############......#............###
##.....#.###.............###################################......#.########################################################.#########.#.....#.#......###.....##########......#......#.....###
##.....#.###.........................#######################......#.#########################......################........#.#########.#.....#.#......#######.##########......#......#.....###
##.....#.###.........................#######################......#.#########.........#######......#######...................#.........#######........#........#########......#.....##.....###
##.....#...............#..............######################......#.#########.........#######......####.......#............###.........#########......#........#########......#.....##########
############...........##.......................##................#.#########.........#######......##.........#............#...........#########......#........#########............##########
############...........##................................###......#.#########.........#######......##.#.......#............#.#.........#########......#........#########.......###############
############...........##.......................##.......##########.#########.........#######.........#.......#..............#.........#########.....##........#########.......###############
##################.....##.......................##.......#######......................#######......####.......######.......###.........#################################.......###############
####.............................................................############################......#################.......###........##################################......################
####......##################.....#######################################################################################################################################.................#####
####......#################......############################.......#####################################################################################............###.................#####
####......#################......############################.......##################################################...........############....................###.###.................#####
####.............................################.........#.........##.......#.............###########################...........############.......####.........###.###.................#####
####.......############..........####......######...........#.......##.......#.###.........#########.............#####...........############.......#####........###.....................#####
##########.############..........####......######.........###.......##.......#.###.........#########.............#####...........############.......#####........#######.................#####
##########.############....................######.........###.......##.......#.###.........#########.............#####...........############.......###############################.##########
##########.############.....##########.....######.........###.......##.......#.###.........#########.............#####...........#################.################################.##########
##########...................#########.....#######.##########.......#..........###.........#########................##...........################..##############################...##########
############################.##............##....................####.###########.......############.............##.##.........................##.###############################.############
############################.##............##.##################.####.###########.##################...........####..............#############.#.....############################.############
#########################..................##.##############..........#######......###########...........#####################################.#.....############################.############
#########################.#####............##.##############..........#######......###########......####.................#####################.#.....############################.############
##.................######.#####............##.##############..........#######......###########......###############......#####################.#.....#######################.......##......###
##.................######.####.............##.##############..........#######......###########.......##############......#####################.#.....#######################.....#.##......###
##.................######.##..................##############..........#######......###########.................####......#####################.#.....#################.....#.....#.........###
##.............................................#############..........########################......##.........####......#####################.......#################...........####......###
##.................###......#..................#############..........########################......##.........####......#######################.....#################...........####......###
##.................###......#..................#############..........########################......##.........#################################.....#################...........####......###
##.................###......#......#................................................................##.........#################################.....#################...........####......###
##.................###......########...........#################################################################################################.....#################.....###################
##############################################################################################################################################################################################
