##############################################################################################################################################################################################
#######################################################################.............############..................############################################################################
#######################################################################.............############.............................#################################################################
#######################################################################...................######..................#.########.##########################################..................#####
#####....................................##############################.............#####.######..................#.##...........######################################..................#####
#####....................................##############################.............#####.######..................#.##...........##################.................###..................#####
#####....................................##############################.............#####.........................#.##..............................................###..................#####
#####....................................##############################.............############..................#.##...........#...........######.................###..................#####
#####....................................####################.......................############..................#.##.......................######.................###..................#####
#####....................................####################.......................############..................#.##.......................######...................#..................#####
#####....................................########...........#.#########.............############..................#.##.......................######.................#.#..................#####
#####....................................########.............#########.............############..................#.##...........#...........######.................#.#..................#####
#####....................................########...........#.#########.............############..................#.##...........#...........######.................#.#..................#####
#####....................................########...........#.##################################..................#..............#...........######.................#.#..................#####
#####....................................########...........#.##################################..................####...........#...........######.................#.#..................#####
#####....................................########...........#.########################################################...........#...........########################....................#####
#####....................................########...........#.########################################################...........#...........##########################..................#####
#####.........................................................########################################################...........######################################..................#####
#################################################...........##########################################################...........######################################..................#####
#################################################...........###########################################################################################################..................#####
#####################################################################################.............################################################################################.###########
########...................#..........###############################################....................#########################################################################.###########
########..............####.#..............###########################################.............######.......................................###################################.###########
########..............####.#..........###.###########################################.............#######......................................#########...........###############.###########
########..............####.#..........###.#############################............##.............#######......................................#########...........###############.###########
########..............####.#..........###.##############..............#............##.............#######......................................##..................###############.###########
########..............####.#..........###.##############...........................##.............#######......................................##.######...........#####.....................#
########..............####.#..........###..........................................##.............#######......................................##.######...........#####.....................#
########..............####.#..........##################...........................##.............#######......................................##.######...........#####.....................#
########..............####............##################............................#.............#######......................................##.######.....................................#
########..............######..........##################..............#.............#.............#######.........................................######...........#####.....................#
########..............######..........##################..............#...........................#######......................................#########...........#####.....................#
########..............##################################..............#............##.............#######......................................#########...........#####.....................#
########################################################..............#............######################......................................#########################.....................#
########################################################..............#............######################......................................#########################.....................#
########################################################..............#............######################......................................#########################.....................#
#######################################################################............######################......................................#########################.....................#
#######################################################################............#####################################################################################.....................#
#######################################################################............#####################################################################################.....................#
##############################################################################################################################################################################################
