##############################################################################################################################################################################################
#...###########....##.......###....#############.......##..###...###########..####....#......#........###########################....#####..#######################....#.....................#
#...###########....##...###........#....................#..###...###########..........#........#..........###########.......##..#........#..############..###..###.....#.##.......###........#
###.###########....##...####.........#.....................#####.##############...........##########......##...######.......##..#.##.....##.#####..#####..###..###.#####.##.........#........#
###.######....#...###...####.################.......##.#.#######....##################.#............##...###...######...........#.##.....##.#......###....###......#####.##.......#....#######
##.....###....#....######.......#################............######.########...............#####....##...###...##...#...........#.####..###.#.#...####.#..####....######.##.#.........########
##..##.###.........######..............###...####............######...######.###.......#...########.##...#.....##...#...............##........#.....##.##.#.......######.##.#.........########
##..##.........##..###..........#..##........####..#.........##........#...#...........#...########.##.###.....##...#...####........##..##...##........##.#...###........##.#.........########
##..##...####..##..###..##......#...#..###......##########...##.######.....#.......################.##.###..#####...#...####....##########...##..####.....#...###....######.#.........########
##.#.....#.....##..###..##...##.#......###......#####...........##.........#...######..######.......##.###..#####...##..####....#####........########.#####...........#####......#############
#..#.#.###.###.....############.#######....##...#####.........####.#########.......##..##...........##.###..#####...##..#######.#####.######...##..##.###########...#..#########.#############
#..#.#..##...#...........######.#######....####...###.........###...########...###.#...##..............###.....##...##..#######.......###......##.........##....#......#########....##########
#..#.#..##...#...#######.######.#######....######...######..........#####..#...........##.###.#...#.........##.##...##..#######................##..##.#................#######......##########
#..#.#..##..##......####.##.....#######....###....#................######....#...#.....##.........#....###.....##...#...#######...#####....#...##..##.#######...#...########.....##.##########
##.#.#..##..####....####..............##..........##....##.##...#.....##..####...#.......###......#....###........#.....#######.#.#####....##..##.....###########...######....#####.##########
#..#.#####..############....######........#..#######.......###....###.##.#####...#........#...######.#...##.....#.##....#######.#..####....##..#####..###########....###......###.....########
#....#####..############..................#..##########....###...........#####...#............######.....###....#.....#########....####....######.....##########.......#...######...#.########
#######################################.#....##########...####...........#####...#####...###########.....###....#......#######.....####.....#####.....######........#..##############......###
##......######...###########......#####..........................................................###.....###....##.....#######..###########.#########.######........#####################..###
##......######...###########.#....##..#.........##############################.....#############.######...##.##.####...########.###..######.#########.#################.........##########..##
##..........##...#########...#######............##############################...................###......##.##.####...########.###..####.....#######.#################..###....####..####..##
##......###.##....########...#######............##############################....##############.###.##...#..##.####.......####.###..####..#..#######.....##################.#######..#.....##
##......###.........##...#.........##########.........................########.........#########.###......#.....####.#.....####.#...#####..##.#######......#################.#######........##
######.####....####.##...##..#####...##.......##......................###########.#....#########.###......#....##..........####.#.#######.#...#####...###...###########..........##...##.#.###
######.####..............##..######.....#.....###.##########......................#....#########.#....#...#....##.........#####....####...#.#######...###...###########..........##...#..#.###
######.##################################.....###.#..........###################.......#########.#........#...#####.......#####....####.#.#.#######...##........#######.####...####...#..#.###
######.##################################.#######.#.#############################......#########..........##....####......####.....####.#.......###...#..........######.###..#..###...####.###
######...........########################.######...............###################...#############........###...####......####..#....##.###.....###......######..######.........###...####.###
#######..#...##..........######....######.##...#..######...###.#####################...###########..##.###......###.......###.........#.###.....#........######..######.........###...####...#
###...#..#...#................#....#####.......#.....#.....###.###....########...#####.####......#..##...#......#..........##.........#......#......#.#..######..............######...####...#
###...#.##...#...........####......##..........#.....#.......#.###....########...####...###.........##...#......#..........##..................##.###.#..######.....####.....######...##.....#
###...#.##...#....###.......#......##.##.#.....##....#..####.#.###....########.....##...####.##.....##...###....####....#..####...#####........##.....................................##..#.##
###.....##........###..##................#..#####.#..#.......#.###.########....#.#.##...####.##..#####...#......###.....#.#######.#######......######....######.#...#####.......##....##.....#
###...#.####.#....###..####...##########....#####....#.......#.#........#........#.##...####.#############.##...###.#.###.#####...####.........####......######.#...######..##..##....#####..#
###...#...#..#....###...#####.#...######....#####............#...#....#..........#.....##....#############..#...##....###..####........####...#####......#..##..#...######..##..##....########
###...#...#..#....#.....#####.....#...##....#####.#..#....###.........#####...#..##.....#...........######..#...##.#..###..###..........#####..#######.........###########..##..#...##########
#######...#.......#.....#####...###......#..#####.#..####.............#########.....#...#....###....######..#...##....#######..#.#......#####..#######......#....##########.........##########
#######.#.#.......#######.......###.........#####.#..####.............#########.....#...#....#......######..####......#######..#.#######################....#....##########........###########
#######......############.......###...###...#####....##############...###############...#......###########..####......#######....#########################..###################....###########
##############################################################################################################################################################################################
